many	many
nihao	nia
xxxx	xxx
sver	sver
histor	istor
china	china
heoo	hcoo
ç½—	ç½—ä¸°
ç‹é“	ç‹é“
k	kA
chat	chat
ä¸­å›½	ä¸­å›½
ç‹åˆ°	æ‹£åˆ°
national	national
ç½‘è¾¾	äº¨è¾¾
hello	hello
k	kA
genreic	genseric
ä¸­å›½äººæ°‘é“¶è¡Œ	ä¸­å›½äººæ°‘é“¶è¡Œ
ä¸­å…±é©å‘½	é—¹é©å‘½
abdcd	abdc
nation	nation
cls	cls
history	history
natia	nativ
ixxx	iphonexx
ç½—æ–‡æµ©	ç½—æ–‡å¹²
hexx	hexa
iph	iphone
zuihao	zhao
[B	B
